88889888
88999898
98988898
98988898
99998999
98888889
99999889
98889999
99998889